( rat )
qnondam domini urai: germaniani ehii tui: ex ipse chartule continente: et
dum multum litigium exinde: abuimus et ipse ludes qui inter nos exinde
iudicandum diressimus: ipse chartules: relegere audisset: iudicabit inter
nohis ut si potuerit: pars mea memorata gemma tivi memorata domina
pitxu hostensiouem lacere: ut quaudo memorata domina theodonanda: di·
vnit: cum memorato domino urso. ipsa petia de memoratum landum qaa-
liter memoratus coherentias circundant: ipsa domina theodonanda: tetigisset
tu ponere mihi exinde: securitatem: ain autem iuraret: pars tua mihi et
dicere: nt ipsa petia ex ipsum hrndum: qualiter memoratas coherentias
urcundant: memorato domino urso ahio tuo tetigisset: in portione da me·
morata domina theodonanda: ahia mea: et athicem exinde: tetigisset ipsa²
ahia rnen ipsa portio quam modo detinet: memorato leo exadello meo:
qnod est ad equale mensura: et memoratum alium fundum tuum: qui est
at memorata parte septentrionis: at memorato abio tuo pertinuisset: per
memorata chartula comparationis: et per memorate chartula commutationis:
quam mihi in iudicio: ostensistis: ego ponere tivi exinde securitatem et
quain nou potuit: pars mea: tvi illut: taliter ostendere: et in presentia
recepia perseum tua cum uno lilio tuo memoratum sacramentum: dicente
mihi ut superius atsernistis: et deliniri exinde vobiscum: in omuibus: iu·
super deliniri¹ tecum et de integra unu terra tua que uocatur silba mau-
ra: posita: in memorato loco qui uhet finis: ala uno latere: terra heredes

capite terra que vocatur bibentium: eh alio cupite coheret memorata hia:
compeniaria: de qua dicebat pars mea: quia in memorata terra ahuit:
memorata ahia meu: nnn interticum iustu ipsu hia: et ea in portione te-
tigit da memorato domino urso ahio tuo: germano suo: et pars tna di-
cehat: epait quia heritas non eat: eet memorata integra terra qualiter
memoratas coherentia: circundant: at memorato domino urso abio tuo per-
tineat per chartule comparationis et commutationis et per chartule secu-
ritate: et ah illo tempore usque modo scs ea dominassetis: iudicatum est
exinde inter nos ut si potuerit: pars mea tivi ostensionem lacere: quom·
modo memorata domina theodouanda tetigisset: ipse interticum intus ipsa
coherentia: ego retdere tivi ipsu interticum: sin autem iurare et pars tua
mihi et dicere ut memorata integra terra qualiter memoratas coherentia: ·

 

