(ee)
clxxv-tu

†ln nomine domini dei salvatoris nostri ihesu Christi imperante do- an,
mino nostro basilio magno imperatore anno: nonodecimor sed et constan· 979.
tino magno imperatore irater eius anno sextodecimo: die decima mensis.
magii indictione septima neapoli: c'ertum est nos leone filium quondam
tauri: et gregoria fibo quondam lupi boo est iugales: et urso filiurn quon-
dam iohanni boo est tbio et nepotes abitatores de loco qui nominetur ne·
petianum super oiibu de galloro: ego memorato urso enm consensum maru:
coniugi mee: sperent dio: promptissima voluntatem: Venumdedimus et tre·
didimus tivi domino stephano venerabilem presbiterum: filiurn quidem domini
leoni custus bero eedesie sancti suberi: idest integra una petia de terra
nostra: une oum arboribus et introitum suum ot omnibus sivi pertinenti-
bus: posita: inmemorato 1000 nepotianum τ seu benumdedinrus et tradidimus
tivi et integris portionibus nostrisr de unum fundioiolum qui est coniuntum
in uno cbapite eum memorate petia de terra: una omn introitum suum et
omnibus sivi pertinentibus: posita in memorato locor qui ooberet at memo·
rate petia de terra: ab uno latere a porto septemtrionis terra de memorata

α beodesia saneti severi: et ab elio latere a parte meridiana terra domini
petri priamenestra: ab uno chapito a parte hoccidente: terra de itta basa
domnesa: sicuti inter se sepis et fossatus exfinatz nb alio chapite a parte
horientis ooberet memoratum tundiriolnm communes unde nos tivi ipsis
portionibus nostris22 exinde benbmdedimns: et deberet at memoratum iun·
diaiolum eommune: a parte septemtrionis fundum de memorata boeclesia
sancti seberi: a parte meridiam tundnm memorati domini petri palemone-
stra: a parte boriontis iundutn de itti denticiz aparte hoccidentis coheret
memorate petia de terra: qne nos tivi superius benumdedimus sicuti inter
se sepis exfinat: unde nibil novis intus ipsas coherenties aliquod exinde

“ remamtt aut reobavtmus nec in aliena emusqm personis: quod apsit oom-
misimus aut iam commictimns potestatem: set a presenti die: et deinceps
a nobis tivi eit venumdatum et traditum in tna tuisque heredibus ait poto-
statom quidquid exinde iacere volueritis: et neque a nobis nequo a nostris:
boredibm neo anobis personis: summittis: nullo tempore nurquam to me-

 

