CXL.

tn· † ln nomine domini dei salvatoris nostri lhesu Christi imperante do-
970. mino nostro basilio magno Imperatore anno decimo sed et nicilorio et con-
stantino magms imperatoribus: anno septimo: die septima: mensis: magii
indictione: tertiadecima neapoli: Horta est itaque intentio inter me gemme
fllia quondam domini sergii et quondam domins anna honesta iemina iuga-
libus personarum: Una cum consensum domini sergii viri mei: et te ri-
delicet domina pitru honesta lemine. lilia quondam domini campuli: eonius
quidem domini stephani militis: de intentione quainter nos abuimm: pro-
pter una petia de lundum positum: super elihu et sanctum ρεῑιιιιιι nt pa-
ternum: qui abet linis eb uno latere fundum monasterii sancti: sabastiani
et ab alio latere a parte septemtrionis coheret fundum tuum memorata do-
mina pitru qui tivi pertinet per qnondam domina meris genetrice toa: et
at memorata genetrice tua pertinuit: per quondam domino urso genitorem
suum: abio tuo: sicuti inter se termines exlinat. et at memorato dominu
urso pertinuit: per commutatio que at eum iecit dominum iohannem lilium
quondam domini marini tribuni: et ab uno eapite: coheret via compe-
niarin: et als elio capite est fundum qui detinet leo exadello germano meo:
quod eat ad equale mensura: de qua dicebat pars mea: atbersus te quia
memorata petia de memoratum fundum: qualiter memoratas mherentias
circundant: mea est et milri pertinet per quondam memorat: domim anna
genetrice mea: ct ct memorata genetrice mea pertinuit: per quondam domina
theodonanda: avia mea genetrice sua: et ipsa avia mea in portione tetigit: a
quondam memorato domino urso avio tum germano ipsius domina theodonan-
da: ahia mea pars tua dicebat: apsit quia veritas non est: set memorate petia
ex ipsum fundum: qualiter memoratas coherentia: circundant: tuum siat et
memorato domino urso abio tuo: in portione tetigisset: da memoratu do·
mina theodonanda : abia mea : propter quod ipso domina theodemanda: ahi:
mea: athicem tetigisset: ipsa portio que ex ipsum lundum detinet me-
morato leo exadelio meo: quod est in trabersum divisum: et est ad equa-

lem mensura: insuper ostensistis milri in iudicio: et uua elnartula securi-
tatis: que lecerat: memorata domina theodonanda: ahia mea: at nomen

 

